 168 210 252 210 2 1 52 0
 252 210 336 210 2 1 52 0
 336 210 420 210 2 1 52 0
 294 252 378 252 1 1 52 0
 420 210 378 252 1 1 36 0
 378 252 336 210 1 1 36 0
 336 210 294 252 1 1 36 0
 294 252 252 210 1 1 36 0
 294 252 336 336 1 1 57 0
 336 336 378 252 1 1 57 0
 168 210 210 231 1 1 28 0
 210 231 294 252 1 1 53 0
 252 210 210 231 1 1 28 0
 378 252 462 231 1 1 53 0
 462 231 504 210 1 1 28 0
 462 231 420 210 1 1 28 0
 420 210 504 210 2 1 52 0
