 168 210 252 189 2 1 53 0
 252 189 336 168 2 1 53 0
 336 168 420 147 2 1 53 0
 420 147 504 126 2 1 53 0
 294 231 378 210 1 1 53 0
 378 210 462 189 1 1 53 0
 462 189 504 126 1 1 46 0
 462 189 420 147 1 1 36 0
 378 210 336 168 1 1 36 0
 294 231 252 189 1 1 36 0
 294 231 336 168 1 1 46 0
 378 210 420 147 1 1 46 0
 168 210 210 252 1 1 36 0
 210 252 294 231 1 1 53 0
 252 189 210 252 1 1 46 0
 294 231 336 294 1 1 46 0
 336 294 378 210 1 1 57 0
 336 294 336 336 3 1 26 0
